11111111111111111
10111110000000001
10011100000C00001
10001000000000001
1101100000P000001
110000000E0000001
10000000000011111
10101111000000001
10101000000000001
11111111111111111
