1111111111
100C1100E1
1101100001
10000P0001
11100000C1
1C00000011
1111111111
