1111111
10100E1
1P00011
1001C01
1C00001
1111111
